##################################################
#@    #    #     #   #          #                #
#   # # ## # ##### # # ######## # # #### ####### #
# ###   ##   #   # # # ######## # #      #       #
#     ###### #     # #        # # #    # #     # #
# ### ######     ### ### #### # # #### # #     # #
# ### #    # #   #   #      # #      #   ### ### #
# ###      # ##### # #      # #### # # ###   #   #
# ### #    #       #   ###### #    # # #   ### # #
# ### ###### ## #####   #     ######   # ###   # # 
#            #      # # #   #     #  ### #   ### #
####### # ####      # #     #     # ##   # # ### #
#       # ######### # ######### ### #  #   # ### #
# ####### ####    # #       ### ### # #### # ### #
#      #  #### ## ### #     ### ###   #### #   # #
# ###### #####      # #     ### ### # #### ### # #
# #    # #####      # #     ### ### #        # # #
# #### # ######## ### ###   #     # ######## # # #
#                 ###                        #   #
##################################################